WWWWWWWWWWWWWWWWWWWW
WCCCCCCCCCCCCCCCCCCW
WCWWWCWWWWWCWCWWWWCW
WCWWWCWWWWWCCCCCCCCW
WCWWWCWWWWWCWCWWWWPW
WCWWWCWWWWWCWCWWWWCW
WCWWWCWWWWWCCCCCCCCW
WCWWWCWWWWWWWCWWWWCW
WCWWWCCCCCCCCCCCCCCW
WCWWWCWWWWWWWCWWWWCW
WCWWWCWWWWWWWCWWWWCW
WCWWWCCCCCCCCCCCCCCW
WCWWWWWWWWWWWWWWWWCW
WCCCCCCCCCCCCCCCCCCW
WCWWWWWWWWWWWWWWWWCW
WCWWWWWWWWWWWWWWWWCW
WCWWWWWWWWWWWWWWWWCW
WCWWWWWWWWWWWWWWWWCW
WCCCCCCCCCCCCCCCCCCW
WWWWWWWWWWWWWWWWWWWW
